%%%%%%%%%%%%%%%%%%%%%%%
%%........%%%...%....G%
%..%P%%........%%%..%%%
%.%......%%%..........%
%.......%%........%%%%%
%%%%%%%%%%%%%%%%%%%%%%%